кат се => дальнобойщик
кат б.с => катb, катc
кат б, кат б. => катb
кат c, кат c., кат с => катc
специализированной => спец
суд механик => судовой механик
суд заседание => судебное заседание
жб, ж б => железобетонных
жд, ж д => железнодорожные
кубм, куб м => кубический метр
метпласт, мет пласт => металлопластиковых
посевмат, посев мат => посевочный материал
ремзоны, рем зоны => ремонтной зоны
сзр, с з р => средства защиты растений
сх, сх => сельльско-хозяйственной
сантех систем, сан тех систем => сантехнических систем
сантех, сан тех => сантехнических
частный предпрениматель, ч п => чп
бух, буха, бухг, бухгалтерскому => бухгалтер
главврач => главный врач
ал, алюм => алюминий
анг, англ => английский
art => арт
асс => ассистент
быстрореж => быстрорежущая
быт => бытовой
вент => вентилируемых
вет => ветеринарный
власн => власним
внутр => внутренней
газ => газовых
ген => генеральный
гл, глав, гол => главного
гос => государственная
гост => гостиничного
гр, груз => грузовой
гус => гусеничного
дет => детский
дит => дитячий
доп => дополнительное
др, драг => драгоценных
драм => драматургический
ед, един => единственном
ел => електро
жен => женской
завед => заведующий
deputy, зам, замест, заст, заступник => заместитель
зап => запасным
зар => заработной
зуб => зубной
ин, иностр => иностранный
инж => инженер
исход => исходящая
інформ, информ => информационного
канц => канцелярия
кап => капитальный
климат => климатического
коммерч => коммерческий
комп => компьютерной
кор, корп => корпоративный
культ => культурный
кух => кухня
лег => легковое
лит => литературный
лич => личный
маг => магазин
малотонаж => малотонажное
манипул => манипуляционная
маш => машинист
мед => медицинская
метал => металлических
металлургич => металлургической
мех => механизированного
мин => минеральных
моб => мобильный
мл, мол, млад => младший
муз => музыкальный
наук => научных
нац => национальный
нач => начальник
неприб => неприбыльная
непрод => непродовольственных
нерж => нержавеющей
ноч => ночные
операц => операционного
освет => осветительных
отд => отделение
оф => официальное
перв, первич => первичная
плуавт => полуавтоматических
пол => половина
пом => помощник
пон => понедельник
пос => поселок
прод => продовольственные
продов => продовольственной
произв => производственного
пром => промышленного
проф => профессиональный
распред => распределительных
роб, раб => рабочий
рус => русский
рыб => рыбный
сантехн => сантехнических
сельхоз => сельльско хозяйственной
сем => семейный
сист => системный
сл => служба
см => сменный
соц => социального
ст => старший
стат => статистической
станция технического обслужевания => сто
стомат => стоматологической
строй => строительного
сцегн => сценарист
т => тонн
тел => телефонной
техн => техническая
травм => травматическое
трансп => транспортного
тур => туристический
удал => удаленная
укр => украинский
упр, управ => управляющий
фарм => фармацевтический
физ, физич, фіз => физических
фин, фін => финансовых
франц => французского
функц => функциональной
харч, пищ => харчової
хім, хим => химической
хоз => хозяйство, хозяйственной
холод => холодильного
худ => художественный
экон => экономическим
эл => электрической
элит, еліт => элитного
юр => юридического
полдня, пол дня => частичная занятость
сх, с х, сг, с г => с/х
монгальщик => мангальщик
тех дир => cto
дир => директор
сборщик пк => hardware specialist
архитектор по => software architect
врач по спортивный медицина, врач по спортивной медицине => врач по лечебной физкультуре и спорту
тимлид, тим лид => team lead
центр в банк, центр в банке, центра в банк, центра в банке => centre банка
водитель грузовики => водитель грузовика
вахтенный метод => вахта
менеджер с продаж,агент с продаж,менеджер с активных продаж,консультант с продаж, специалист с продаж, специалист по обеспечение сбыта => менеджер по продажам
менеджер по сбыту => менеджер по продажам
иностранная речь => иностранный язык
менеджер с сопровождения продаж => сопровождение продаж
работа на своему авто => с авто
менеджер с административной деятельности => офис-менеджер
администратор офису => офис-менеджер
специалист с интернет маркетингу => интернет-маркетолог
менеджер с управления проектами => руководитель проектов
менеджер по сопровождения => сопровождение продаж
специалист с логистики => логист
net программирование => net
менеджер с телефонного продаж => менеджер телефонных продаж
